[
    "###################",
    "#########.......###",
    "########..###.#.###",
    "######..#..D.#S.###",
    "#####...##.########",
    "####..D.#........##",
    "###..####..###.#.##",
    "##........#D.....##",
    "##..#.###.###.##.##",
    "##..#.#.D..#..#..##",
    "##....#.###..#.#.##",
    "##..#.#..........##",
    "##..#.#####.###.#.#",
    "##..#.....#.....#.#",
    "###.####..#####.###",
    "#####....@......###",
    "###################"
]